16進位	16进制
16進位制	16进位制
A型肝炎	甲型肝炎
A肝	甲肝
B型肝炎	乙型肝炎
B肝	乙肝
C型肝炎	丙型肝炎
C肝	丙肝
IP位址	IP地址
一份子	一分子
三十六著	三十六着
三極體	三极管
三藩市	旧金山
三蘭港	达累斯萨拉姆
上落客	上下客
下著	下着
下著作	下著作
下著名	下著名
下著录	下著录
下著有	下著有
下著称	下著称
下著稱	下著称
下著者	下著者
下著述	下著述
下著錄	下著录
不著	不着
不著名	不著名
不著書	不著书
不著稱	不著称
不著述	不著述
不著錄	不著录
主機板	主板
乘著	乘着
乘著作	乘著作
乘著名	乘著名
乘著書	乘著书
乘著称	乘著称
乘著稱	乘著称
乘著者	乘著者
乘著述	乘著述
乘著錄	乘著录
乙份	一份
乙個	一个
乙太網	以太网
乙隻	一只
乾姊	干姐
了結他	了结他
二極體	二极管
二進位	二进制
二進位制	二进位制
亚细安	东盟
亞塞拜然	阿塞拜疆
亞斯文	阿斯旺
亞歷山卓	亚历山大
亞里斯多德	亚里士多德
交帳	交账
亮著	亮着
亮著《	亮著《
亮著作	亮著作
亮著名	亮著名
亮著書	亮著书
亮著称	亮著称
亮著稱	亮著称
亮著者	亮著者
亮著述	亮著述
亮著錄	亮著录
人工智慧	人工智能
什勒斯維希	石勒苏益格
介面	界面
仗著	仗着
仗著作	仗著作
仗著名	仗著名
仗著書	仗著书
仗著稱	仗著称
仗著者	仗著者
仗著述	仗著述
仗著錄	仗著录
付帳	付账
代表著	代表着
代表著作	代表著作
代表著名	代表著名
代表著書	代表著书
代表著稱	代表著称
代表著者	代表著者
代表著述	代表著述
代表著錄	代表著录
仲介	中介
份內	分内
份外	分外
份外卖	份外卖
份外，	份外，
份量	分量
伊利諾	伊利诺伊
伊利諾伊	伊利诺伊
伊斯坦堡	伊斯坦布尔
伊斯蘭瑪巴德	伊斯兰堡
伊波拉	埃博拉
伊莉莎白	伊丽莎白
伏地挺身	俯卧撑
伏著	伏着
伯明罕	伯明翰
伴著	伴着
伴著作	伴著作
伴著名	伴著名
伴著書	伴著书
伴著稱	伴著称
伴著者	伴著者
伴著述	伴著述
伴著錄	伴著录
伺服器	服务器
位元組	字节
低著	低着
低著作	低著作
低著名	低著名
低著書	低著书
低著称	低著称
低著稱	低著称
低著者	低著者
低著述	低著述
低著錄	低著录
住著	住着
住著作	住著作
住著名	住著名
住著書	住著书
住著称	住著称
住著稱	住著称
住著者	住著者
住著述	住著述
住著錄	住著录
作業系統	操作系统
來著	来着
來著作	来著作
來著名	来著名
來著書	来著书
來著稱	来著称
來著者	来著者
來著述	来著述
來著錄	来著录
侏儸紀	侏罗纪
促著	促着
保護著	保护着
保鑣	保镖
保障著	保障着
保障著作	保障著作
保障著名	保障著名
保障著書	保障著书
保障著称	保障著称
保障著稱	保障著称
保障著者	保障著者
保障著述	保障著述
保障著錄	保障著录
信著	信着
信著《	信著《
信著作	信著作
信著名	信著名
信著書	信著书
信著称	信著称
信著稱	信著称
信著者	信著者
信著述	信著述
信著錄	信著录
倒帳	倒账
候著	候着
候著作	候著作
候著名	候著名
候著書	候著书
候著稱	候著称
候著者	候著者
候著述	候著述
候著錄	候著录
借著	借着
借著作	借著作
借著名	借著名
借著書	借著书
借著稱	借著称
借著者	借著者
借著述	借著述
借著錄	借著录
假帳	假账
做著	做着
做著作	做著作
做著名	做著名
做著書	做著书
做著稱	做著称
做著者	做著者
做著述	做著述
做著錄	做著录
健力士世界紀錄	吉尼斯世界纪录
側著	侧着
側著作	侧著作
側著名	侧著名
側著書	侧著书
側著稱	侧著称
側著者	侧著者
側著述	侧著述
側著錄	侧著录
偷著	偷着
偷著作	偷著作
偷著名	偷著名
偷著書	偷著书
偷著稱	偷著称
偷著者	偷著者
偷著述	偷著述
偷著錄	偷著录
傅利葉	傅里叶
備著	备着
備著作	备著作
備著名	备著名
備著書	备著书
備著稱	备著称
備著者	备著者
備著述	备著述
備著錄	备著录
傳著	传着
傳著作	传著作
傳著名	传著名
傳著書	传著书
傳著稱	传著称
傳著者	传著者
傳著述	传著述
傳著錄	传著录
優先順序	优先级
光碟機	光驱
光著	光着
光著《	光著《
光著作	光著作
光著名	光著名
光著書	光著书
光著称	光著称
光著稱	光著称
光著者	光著者
光著述	光著述
光著錄	光著录
克卜勒	开普勒
克羅埃西亞	克罗地亚
入帳	入账
全球資訊網	万维网
八進位	八进制
八進位制	八进位制
公升	升
公厘	毫米
公尺	米
公帳	公账
公釐	毫米
六進位	六进制
六進位制	六进位制
共和联邦	英联邦
冒著	冒着
冒著作	冒著作
冒著名	冒著名
冒著書	冒著书
冒著稱	冒著称
冒著者	冒著者
冒著述	冒著述
冒著錄	冒著录
凱薩琳	凯瑟琳
分佈著	分布着
分布著	分布着
列印	打印
列支敦斯登	列支敦士登
別著	别着
刮著	刮着
到帳	到账
制著	制着
制著作	制著作
制著名	制著名
制著書	制著书
制著稱	制著称
制著者	制著者
制著述	制著述
制著錄	制著录
刻著	刻着
刻著作	刻著作
刻著名	刻著名
刻著書	刻著书
刻著称	刻著称
刻著稱	刻著称
刻著者	刻著者
刻著述	刻著述
刻著錄	刻著录
前波莫瑞	前波美拉尼亚
劃著	划着
功能變數名稱	域名
加彭	加蓬
加泰隆尼亞	加泰罗尼亚
加薩走廊	加沙地带
努力著	努力着
努力著作	努力著作
努力著名	努力著名
努力著書	努力著书
努力著称	努力著称
努力著稱	努力著称
努力著者	努力著者
努力著述	努力著述
努力著錄	努力著录
動畫影集	系列动画片
動著	动着
動著作	动著作
動著名	动著名
動著書	动著书
動著稱	动著称
動著者	动著者
動著述	动著述
動著錄	动著录
包著	包着
匯流排	总线
區域網	局域网
區域網路	局域网络
十進位	十进制
十進位制	十进位制
千里達	特立尼达
千里達及托巴哥	特立尼达和多巴哥
卑詩省	不列颠哥伦比亚省
南斯拉夫聯邦共和國	南斯拉夫联盟共和国
南韓	韩国
占士邦	詹姆斯·邦德
占著	占着
占著作	占著作
占著名	占著名
占著者	占著者
卡佩雅蒂	卡普里亚蒂
卡斯楚	卡斯特罗
卯足	铆足
印著	印着
印著《	印著《
印著作	印著作
印著名	印著名
印著書	印著书
印著稱	印著称
印著者	印著者
印著述	印著述
印著錄	印著录
印表機	打印机
厄利垂亚	厄立特里亚
厄利垂亞	厄立特里亚
厄瓜多	厄瓜多尔
厄瓜多尔	厄瓜多尔
厄瓜多爾	厄瓜多尔
厄立特里亞	厄立特里亚
原始碼	源代码
原子筆	圆珠笔
受著	受着
受著作	受著作
受著名	受著名
受著書	受著书
受著稱	受著称
受著者	受著者
受著述	受著述
受著錄	受著录
叫著	叫着
叫著作	叫著作
叫著名	叫著名
叫著書	叫著书
叫著稱	叫著称
叫著者	叫著者
叫著述	叫著述
叫著錄	叫著录
可攜式	便携式
台帳	台账
叱吒	叱咤
史丹福大學	斯坦福大学
史特勞斯	斯特劳斯
史瓦帝尼	斯威士兰
史瓦濟蘭	斯威士兰
史達林	斯大林
吃著	吃着
吉力馬札羅	乞力马扎罗
吉布地	吉布提
吉里巴斯	基里巴斯
吊著	吊着
名份	名分
吐瓦魯	图瓦卢
向著	向着
向著作	向著作
向著名	向著名
向著書	向著书
向著稱	向著称
向著者	向著者
向著述	向著述
向著錄	向著录
含著	含着
含著作	含著作
含著名	含著名
含著書	含著书
含著稱	含著称
含著者	含著者
含著述	含著述
含著錄	含著录
吹著	吹着
吹著作	吹著作
吹著名	吹著名
吹著書	吹著书
吹著稱	吹著称
吹著者	吹著者
吹著述	吹著述
吹著錄	吹著录
呆帳	呆账
呆著	呆着
味著	味着
味著作	味著作
味著名	味著名
味著書	味著书
味著称	味著称
味著稱	味著称
味著者	味著者
味著述	味著述
味著錄	味著录
咖哩	咖喱
咬著	咬着
哥德式	哥特式
哥斯大黎加	哥斯达黎加
哭著	哭着
哭著作	哭著作
哭著名	哭著名
哭著書	哭著书
哭著稱	哭著称
哭著者	哭著者
哭著述	哭著述
哭著錄	哭著录
唐納·川普	唐纳德·特朗普
唯讀	只读
唱著	唱着
唱著作	唱著作
唱著名	唱著名
唱著書	唱著书
唱著稱	唱著称
唱著者	唱著者
唱著述	唱著述
唱著錄	唱著录
啸吒	啸咤
喀拉蚩	卡拉奇
喜歡著	喜欢着
喝著	喝着
喝著作	喝著作
喝著名	喝著名
喝著書	喝著书
喝著稱	喝著称
喝著者	喝著者
喝著述	喝著述
喝著錄	喝著录
喬治·歐威爾	乔治·奥威尔
喬治亞字母	格鲁吉亚字母
單眼相機	单反相机
單鏡反光機	单反相机
嗅著	嗅着
嘉芙蓮	凯瑟琳
嚷著	嚷着
嚷著作	嚷著作
嚷著名	嚷著名
嚷著書	嚷著书
嚷著稱	嚷著称
嚷著者	嚷著者
嚷著述	嚷著述
嚷著錄	嚷著录
回著	回着
回著名	回著名
因著	因着
因著〈	因著〈
因著《	因著《
因著作	因著作
因著名	因著名
因著录	因著录
因著書	因著书
因著稱	因著称
因著者	因著者
因著述	因著述
因著錄	因著录
困著	困着
困著作	困著作
困著名	困著名
困著書	困著书
困著稱	困著称
困著者	困著者
困著述	困著述
困著錄	困著录
固著	固着
圍著	围着
圍著作	围著作
圍著名	围著名
圍著書	围著书
圍著稱	围著称
圍著者	围著者
圍著述	围著述
圍著錄	围著录
土魯斯	图卢兹
坎城	戛纳
坎培拉	堪培拉
坐著	坐着
坐著作	坐著作
坐著名	坐著名
坐著書	坐著书
坐著稱	坐著称
坐著者	坐著者
坐著述	坐著述
坐著錄	坐著录
坚杜拜	坚杜拜
坦尚尼亞	坦桑尼亚
埋著	埋着
執行長、	首席执行官、
執行長。	首席执行官。
執行長，	首席执行官，
堂姊	堂姐
堅杜拜	坚杜拜
堅貞著	坚贞着
報帳	报账
塑膠袋	塑料袋
塗著	涂着
塞席爾	塞舌尔
塞拉耶佛	萨拉热窝
塞普勒斯	塞浦路斯
塞爾維亞與蒙特內哥羅	塞尔维亚和黑山
塞維亞	塞维利亚
壓著	压着
壓著作	压著作
壓著名	压著名
壓著書	压著书
壓著稱	压著称
壓著者	压著者
壓著述	压著述
壓著錄	压著录
士多啤梨	草莓
外掛程式	插件
外部連結	外部链接
多明尼加	多米尼加
夢著	梦着
夢著《	梦著《
夢著作	梦著作
夢著名	梦著名
夢著書	梦著书
夢著稱	梦著称
夢著者	梦著者
夢著述	梦著述
夢著錄	梦著录
大姊	大姐
大姊姊	大姐姐
大寮	大寮
大英國協	英联邦
天份	天分
太空梭	航天飞机
太空衣	宇航服
太空飛行員	宇航员
太陽電腦	太阳微系统
夾著	夹着
夾著作	夹著作
夾著名	夹著名
夾著書	夹著书
夾著稱	夹著称
夾著者	夹著者
夾著述	夹著述
夾著錄	夹著录
奈及利亞	尼日利亚
奈洛比	内罗毕
奧勒岡	俄勒冈
姊夫	姐夫
姊姊	姐姐
姊弟	姐弟
威斯伐倫	威斯特法伦
威爾斯	威尔士
威騰電子	西部数据
字型大小	字号
存在著	存在着
存著	存着
存著作	存著作
存著名	存著名
孟德爾遜	门德尔松
孟德爾頌	门德尔松
學姊	学姐
學著	学着
學著作	学著作
學著名	学著名
學著書	学著书
學著稱	学著称
學著者	学著者
學著述	学著述
學著錄	学著录
守著	守着
守著作	守著作
守著名	守著名
守著書	守著书
守著称	守著称
守著稱	守著称
守著者	守著者
守著述	守著述
守著錄	守著录
安哈特	安哈尔特
安地卡	安提瓜
安地卡及巴布達	安提瓜和巴布达
宏都拉斯	洪都拉斯
定著	定着
定著《	定著《
定著作	定著作
定著名	定著名
定著書	定著书
定著称	定著称
定著稱	定著称
定著者	定著者
定著述	定著述
定著錄	定著录
宿霧	宿务
密执安	密歇根
密西根	密歇根
富比士	福布斯
寫著	写着
寫著作	写著作
寫著名	写著名
寫著書	写著书
寫著稱	写著称
寫著者	写著者
寫著述	写著述
寫著錄	写著录
寮人民民主共和國	老挝人民民主共和国
寮保護國	老挝保护国
寮國	老挝
寮語	老挝语
尋著	寻着
尋著作	寻著作
尋著名	寻著名
尋著書	寻著书
尋著稱	寻著称
尋著者	寻著者
尋著述	寻著述
尋著錄	寻著录
對帳	对账
對著	对着
對著作	对著作
對著名	对著名
對著書	对著书
對著稱	对著称
對著者	对著者
對著述	对著述
對著錄	对著录
尖峰時段	高峰时段
尖峰時間	高峰时间
尚比亞	赞比亚
尼日共和國	尼日尔共和国
尾班車	末班车
展著	展着
展著《	展著《
展著作	展著作
展著名	展著名
展著書	展著书
展著稱	展著称
展著者	展著者
展著述	展著述
展著錄	展著录
峇里	巴厘
工具機	机床
巨集	宏
巴塞隆拿	巴塞罗那
巴塞隆納	巴塞罗那
巴斯拉	巴士拉
巴貝多	巴巴多斯
布吉納法索	布基纳法索
布拉提斯拉瓦	布拉迪斯拉发
布殊	布什
布蘭登堡	勃兰登堡
布隆泉	布隆方丹
希冀著	希冀着
希拉莉	希拉里
希拉蕊	希拉里
希特拉	希特勒
帕拉林匹克	残疾人奥林匹克
帕運	残奥
帕邁拉環礁	巴尔米拉环礁
帛琉	帕劳
席哈克	希拉克
帳上	账上
帳冊	账册
帳務	账务
帳單	账单
帳外	账外
帳戶	账户
帳房	账房
帳本	账本
帳款	账款
帳目	账目
帳簿	账簿
帳號	账号
帳面	账面
帶著	带着
帶著作	带著作
帶著名	带著名
帶著書	带著书
帶著稱	带著称
帶著者	带著者
帶著述	带著述
帶著錄	带著录
幫浦	泵
幫著	帮着
幫著作	帮著作
幫著名	帮著名
幫著書	帮著书
幫著稱	帮著称
幫著者	帮著者
幫著述	帮著述
幫著錄	帮著录
幹著	干着
幹著名	幹著名
幹著稱	幹著称
幾內亞比索	几内亚比绍
庇護著	庇护着
庇里牛斯	比利牛斯
庫德人	库尔德人
庫德斯坦	库尔德斯坦
庫德族	库尔德族
建帳	建账
強斯頓環礁	约翰斯顿岛
形上學	形而上学
待著	待着
待著作	待著作
待著名	待著名
待著書	待著书
待著稱	待著称
待著者	待著者
待著述	待著述
待著錄	待著录
得著	得着
得著作	得著作
得著名	得著名
得著書	得著书
得著稱	得著称
得著者	得著者
得著述	得著述
得著錄	得著录
御姊	御姐
循著	循着
循著作	循著作
循著名	循著名
循著書	循著书
循著稱	循著称
循著者	循著者
循著述	循著述
循著錄	循著录
徵狀	症状
德勒斯登	德累斯顿
德希達	德里达
德蕾莎·梅伊	特蕾莎·梅
心著	心着
心著《	心著《
心著作	心著作
心著名	心著名
心著書	心著书
心著称	心著称
心著稱	心著称
心著者	心著者
心著述	心著述
心著錄	心著录
忌廉	奶油
忍著	忍着
忍著作	忍著作
忍著名	忍著名
忍著書	忍著书
忍著稱	忍著称
忍著者	忍著者
忍著述	忍著述
忍著錄	忍著录
忙著	忙着
忙著作	忙著作
忙著名	忙著名
忙著書	忙著书
忙著稱	忙著称
忙著者	忙著者
忙著述	忙著述
忙著錄	忙著录
忠貞著	忠贞着
快閃記憶體	闪存
急著	急着
急著作	急著作
急著名	急著名
急著書	急著书
急著稱	急著称
急著者	急著者
急著述	急著述
急著錄	急著录
恰如其份	恰如其分
悠著	悠着
悠著作	悠著作
悠著名	悠著名
悠著書	悠著书
悠著稱	悠著称
悠著者	悠著者
悠著述	悠著述
悠著錄	悠著录
悶著	闷着
想著	想着
想著作	想著作
想著名	想著名
想著書	想著书
想著称	想著称
想著稱	想著称
想著者	想著者
想著述	想著述
想著錄	想著录
愛滋	艾滋
愛著	爱着
愛著作	爱著作
愛著名	爱著名
愛著書	爱著书
愛著稱	爱著称
愛著者	爱著者
愛著述	爱著述
愛著錄	爱著录
愛護著	爱护着
慣著	惯着
慣著作	惯著作
慣著名	惯著名
慣著書	惯著书
慣著稱	惯著称
慣著者	惯著者
慣著述	惯著述
慣著錄	惯著录
憑著	凭着
憑著作	凭著作
憑著名	凭著名
憑著者	凭著者
應用程式	应用程序
應著	应着
應著作	应著作
應著名	应著名
應著書	应著书
應著稱	应著称
應著者	应著者
應著述	应著述
應著錄	应著录
懷著	怀着
懷著《	怀著《
懷著作	怀著作
懷著名	怀著名
懷著書	怀著书
懷著稱	怀著称
懷著者	怀著者
懷著述	怀著述
懷著錄	怀著录
戀著	恋着
戀著作	恋著作
戀著名	恋著名
戀著書	恋著书
戀著稱	恋著称
戀著者	恋著者
戀著述	恋著述
戀著錄	恋著录
戈巴契夫	戈尔巴乔夫
成份	成分
成份股	成份股
戰著	战着
戰著作	战著作
戰著名	战著名
戰著書	战著书
戰著稱	战著称
戰著者	战著者
戰著述	战著述
戰著錄	战著录
戴卓爾	撒切尔
戴著	戴着
戴著作	戴著作
戴著名	戴著名
戴著書	戴著书
戴著稱	戴著称
戴著者	戴著者
戴著述	戴著述
戴著錄	戴著录
打著	打着
打著作	打著作
打著名	打著名
打著書	打著书
打著稱	打著称
打著者	打著者
打著述	打著述
打著錄	打著录
托巴哥	多巴哥
扛著	扛着
扛著作	扛著作
扛著名	扛著名
扛著書	扛著书
扛著稱	扛著称
扛著者	扛著者
扛著述	扛著述
扛著錄	扛著录
抓著	抓着
抓著作	抓著作
抓著名	抓著名
抓著稱	抓著称
抓著者	抓著者
抓著述	抓著述
抓著錄	抓著录
投機份子	投机分子
披索	比索
披著	披着
披著作	披著作
披著名	披著名
披著書	披著书
披著稱	披著称
披著者	披著者
披著述	披著述
披著錄	披著录
披頭四	披头士
抬著	抬着
抬著作	抬著作
抬著名	抬著名
抬著稱	抬著称
抬著者	抬著者
抬著述	抬著述
抬著錄	抬著录
抱著	抱着
抱著作	抱著作
抱著名	抱著名
抱著稱	抱著称
抱著者	抱著者
抱著述	抱著述
抱著錄	抱著录
拉著	拉着
拉著作	拉著作
拉著名	拉著名
拉著書	拉著书
拉著稱	拉著称
拉著者	拉著者
拉著述	拉著述
拉著錄	拉著录
拎著	拎着
拎著作	拎著作
拎著名	拎著名
拎著稱	拎著称
拎著者	拎著者
拎著述	拎著述
拎著錄	拎著录
拖著	拖着
拖著作	拖著作
拖著名	拖著名
拖著稱	拖著称
拖著者	拖著者
拖著述	拖著述
拖著錄	拖著录
拼著	拼着
拼著作	拼著作
拼著名	拼著名
拼著稱	拼著称
拼著者	拼著者
拼著述	拼著述
拼著錄	拼著录
拿著	拿着
拿著作	拿著作
拿著名	拿著名
拿著稱	拿著称
拿著者	拿著者
拿著述	拿著述
拿著錄	拿著录
持著	持着
持著作	持著作
持著名	持著名
持著稱	持著称
持著者	持著者
持著述	持著述
持著錄	持著录
挑著	挑着
挑著作	挑著作
挑著名	挑著名
挑著稱	挑著称
挑著者	挑著者
挑著述	挑著述
挑著錄	挑著录
挨著	挨着
挨著作	挨著作
挨著名	挨著名
挨著稱	挨著称
挨著者	挨著者
挨著述	挨著述
挨著錄	挨著录
捆著	捆着
捆著作	捆著作
捆著名	捆著名
捆著稱	捆著称
捆著者	捆著者
捆著述	捆著述
捆著錄	捆著录
掃瞄	扫描
掃瞄器	扫描仪
掌上壓	俯卧撑
掖著	掖着
掖著作	掖著作
掖著名	掖著名
掖著稱	掖著称
掖著者	掖著者
掖著述	掖著述
掖著錄	掖著录
掙著	挣着
掙著作	挣著作
掙著名	挣著名
掙著書	挣著书
掙著稱	挣著称
掙著者	挣著者
掙著述	挣著述
掙著錄	挣著录
掛著	挂着
接著	接着
接著作	接著作
接著名	接著名
接著稱	接著称
接著者	接著者
接著述	接著述
接著錄	接著录
控制項	控件
揉著	揉着
揉著作	揉著作
揉著名	揉著名
揉著書	揉著书
揉著稱	揉著称
揉著者	揉著者
揉著述	揉著述
揉著錄	揉著录
提比里西	第比利斯
提著	提着
提著作	提著作
提著名	提著名
提著稱	提著称
提著者	提著者
提著述	提著述
提著錄	提著录
揮著	挥着
揮著作	挥著作
揮著名	挥著名
揮著稱	挥著称
揮著者	挥著者
揮著述	挥著述
揮著錄	挥著录
搜尋引擎	搜索引擎
搶著	抢着
摟著	搂着
摟著作	搂著作
摟著名	搂著名
摟著稱	搂著称
摟著者	搂著者
摟著述	搂著述
摟著錄	搂著录
摩斯比港	莫尔斯比港
撒拉威阿拉伯	阿拉伯撒哈拉
撞球	台球
撼著	撼着
撼著作	撼著作
撼著名	撼著名
撼著書	撼著书
撼著稱	撼著称
撼著者	撼著者
撼著述	撼著述
撼著錄	撼著录
擋著	挡着
擋著作	挡著作
擋著名	挡著名
擋著稱	挡著称
擋著者	挡著者
擋著述	挡著述
擋著錄	挡著录
擔著	担着
據著	据着
據著作	据著作
據著名	据著名
據著書	据著书
據著稱	据著称
據著者	据著者
據著述	据著述
據著錄	据著录
擡著	抬着
擺著	摆着
擺著作	摆著作
擺著名	摆著名
擺著稱	摆著称
擺著者	摆著者
擺著述	摆著述
擺著錄	摆著录
攜帶型	便携式
收帳	收账
收錄著	收录着
放帳	放账
放著	放着
放著作	放著作
放著名	放著名
放著称	放著称
放著稱	放著称
敞著	敞着
敞著作	敞著作
敞著名	敞著名
敞著稱	敞著称
敞著者	敞著者
敞著述	敞著述
敞著錄	敞著录
散佈著	散布着
散布著	散布着
數位化	数字化
數位技術	数字技术
數位照相機	数码照相机
數位相機	数码相机
數位訊號	数字信号
數位電視	数字电视
數位音樂	数字音乐
數據機	调制解调器
數碼訊號	数字信号
數碼電視	数字电视
數著	数着
數著作	数著作
數著名	数著名
數著稱	数著称
數著者	数著者
數著述	数著述
數著錄	数著录
文翠珊	特蕾莎·梅
斥著	斥着
斥著作	斥著作
斥著名	斥著名
斥著書	斥著书
斥著稱	斥著称
斥著者	斥著者
斥著述	斥著述
斥著錄	斥著录
斯堪地那維亞	斯堪的纳维亚
斯洛維尼亞	斯洛文尼亚
昂山素姬	昂山素季
昂著	昂着
昂著作	昂著作
昂著名	昂著名
昂著書	昂著书
昂著稱	昂著称
昂著者	昂著者
昂著述	昂著述
昂著錄	昂著录
昇陽電腦	太阳微系统
明白帳	明白账
映著	映着
映著作	映著作
映著名	映著名
映著書	映著书
映著稱	映著称
映著者	映著者
映著述	映著述
映著錄	映著录
显著	显著
晃著	晃着
晃著作	晃著作
晃著名	晃著名
晃著稱	晃著称
晃著者	晃著者
晃著述	晃著述
晃著錄	晃著录
普利托利亞	比勒陀利亚
普利茲	普利策
普立茲獎	普利策奖
晶元	芯片
晶片	芯片
智慧卡	智能卡
智慧型	智能
智慧手機	智能手机
智慧機器人	智能机器人
智慧財產權	知识产权
智財權	知识产权
暗著	暗着
暗著作	暗著作
暗著名	暗著名
暗著書	暗著书
暗著稱	暗著称
暗著者	暗著者
暗著述	暗著述
暗著錄	暗著录
有著	有着
有著作	有著作
有著名	有著名
有著書	有著书
有著稱	有著称
有著者	有著者
有著述	有著述
有著錄	有著录
望著	望着
望著作	望著作
望著名	望著名
望著稱	望著称
望著者	望著者
望著述	望著述
望著錄	望著录
朝著	朝着
朝著作	朝著作
朝著名	朝著名
朝著稱	朝著称
朝著者	朝著者
朝著述	朝著述
朝著錄	朝著录
本份	本分
本帳	本账
本本份份	本本分分
本著	本着
本著作	本著作
本著名	本著名
本著書	本著书
本著稱	本著称
本著者	本著者
本著述	本著述
本著錄	本著录
李奧納多	列奥那多
杜塞道夫	杜塞尔多夫
杜拜	迪拜
束著	束着
東加王國	汤加王国
東協	东盟
東協助	东协助
東協會	东协会
東協議	东协议
東南亞國家協會	东南亚国家联盟
板著臉	板着脸
枕著	枕着
枕著作	枕著作
枕著名	枕著名
枕著稱	枕著称
枕著者	枕著者
枕著述	枕著述
枕著錄	枕著录
柏林圍牆	柏林墙
查帳	查账
查維茲	查韦斯
柯德莉·夏萍	奥黛丽·赫本
柯林頓	克林顿
柴契爾	撒切尔
格林美獎	格莱美奖
格瑞那丁	格林纳丁斯
格瑞那達	格林纳达
桌上型電腦	台式电脑
梅赫西迪	梅赛德斯
梳著	梳着
梳著作	梳著作
梳著名	梳著名
梳著稱	梳著称
梳著者	梳著者
梳著述	梳著述
梳著錄	梳著录
梵谷	梵高
森巴舞	桑巴舞
槍枝	枪支
樂著	乐着
樂著《	乐著《
樂著作	乐著作
樂著名	乐著名
樂著書	乐著书
樂著稱	乐著称
樂著者	乐著者
樂著述	乐著述
樂著錄	乐著录
標志著	标志着
標誌著	标志着
模里西斯	毛里求斯
樸茨茅夫	朴茨茅斯
機械人	机器人
機率	几率
欄位	字段
欠帳	欠账
歐巴馬	奥巴马
正體中文	繁体中文
死帳	死账
殺著	杀着
殺著作	杀著作
殺著名	杀著名
殺著書	杀著书
殺著稱	杀著称
殺著者	杀著者
殺著述	杀著述
殺著錄	杀著录
毛里裘斯	毛里求斯
氧份	氧分
水份	水分
水氣	水汽
求著	求着
求著作	求著作
求著名	求著名
求著書	求著书
求著稱	求著称
求著者	求著者
求著述	求著述
求著錄	求著录
汕埠	圣佩德罗苏拉
汶萊	文莱
沈著	沉着
沉著	沉着
沉著作	沉著作
沉著名	沉著名
沉著書	沉著书
沉著稱	沉著称
沉著者	沉著者
沉著述	沉著述
沉著錄	沉著录
沖帳	冲账
沖著	冲着
沖著。	冲著。
沖著《	冲著《
沖著（	冲著（
沖著，	冲著，
沙地阿拉伯	沙特阿拉伯
沙烏地阿拉伯	沙特阿拉伯
沿著	沿着
沿著作	沿著作
沿著名	沿著名
沿著書	沿著书
沿著稱	沿著称
沿著者	沿著者
沿著述	沿著述
沿著錄	沿著录
波士尼亞	波斯尼亚
波士尼亞與赫塞哥維納	波斯尼亚和黑塞哥维那
波札那	博茨瓦纳
波里活	宝莱坞
活著	活着
活著作	活著作
活著名	活著名
活著書	活著书
活著稱	活著称
活著者	活著者
活著述	活著述
活著錄	活著录
派屈克	帕特里克
流動作業系統	移动操作系统
流動應用程式	移动应用程序
流動支付	移动支付
流動網絡	移动网络
流動裝置	移动设备
流動電話	移动电话
流水帳	流水账
流著	流着
流著作	流著作
流著名	流著名
流著書	流著书
流著稱	流著称
流著者	流著者
流著述	流著述
流著錄	流著录
流露著	流露着
浮著	浮着
浮著作	浮著作
浮著名	浮著名
浮著書	浮著书
浮著稱	浮著称
浮著者	浮著者
浮著述	浮著述
浮著錄	浮著录
海洛英	海洛因
海浬	海里
涼著	凉着
涼著作	凉著作
涼著名	凉著名
涼著書	凉著书
涼著稱	凉著称
涼著者	凉著者
涼著述	凉著述
涼著錄	凉著录
混帳	混账
清帳	清账
清澈	清澈
渴著	渴着
渴著作	渴著作
渴著名	渴著名
渴著書	渴著书
渴著稱	渴著称
渴著者	渴著者
渴著述	渴著述
渴著錄	渴著录
湊合著	凑合着
溢著	溢着
溢著作	溢著作
溢著名	溢著名
溢著書	溢著书
溢著稱	溢著称
溢著者	溢著者
溢著述	溢著述
溢著錄	溢著录
溫納圖	瓦努阿图
溫荷克	温得和克
滑鼠	鼠标
滑鼠蛇	滑鼠蛇
滿16進位	满16进位
滿二進位	满二进位
滿八進位	满八进位
滿六進位	满六进位
滿十六進位	满十六进位
滿十進位	满十进位
滿著	满着
滿著作	满著作
滿著名	满著名
滿著者	满著者
演化論	进化论
演算法	算法
演著	演着
演著作	演著作
演著名	演著名
演著書	演著书
演著稱	演著称
演著者	演著者
演著述	演著述
演著錄	演著录
漢諾瓦	汉诺威
漫著	漫着
漫著作	漫著作
漫著名	漫著名
漫著書	漫著书
漫著稱	漫著称
漫著者	漫著者
漫著述	漫著述
漫著錄	漫著录
潤著	润着
潤著作	润著作
潤著名	润著名
潤著書	润著书
潤著稱	润著称
潤著者	润著者
潤著述	润著述
潤著錄	润著录
潮寮	潮寮
澈底	彻底
為著	为着
為著《	为著《
為著作	为著作
為著名	为著名
為著稱	为著称
為著者	为著者
為著述	为著述
為著錄	为著录
烏龍麵	乌冬面
煞車	刹车
照著	照着
照著作	照著作
照著名	照著名
照著書	照著书
照著稱	照著称
照著者	照著者
照著述	照著述
照著錄	照著录
燒著	烧着
燒著作	烧著作
燒著名	烧著名
燒著稱	烧著称
燒著者	烧著者
燒著述	烧著述
燒著錄	烧著录
營運長、	首席运营官、
營運長。	首席运营官。
營運長，	首席运营官，
爛帳	烂账
爭著	争着
爭著作	争著作
爭著名	争著名
爭著書	争著书
爭著稱	争著称
爭著者	争著者
爭著述	争著述
爭著錄	争著录
片語	词组
牽著	牵着
牽著作	牵著作
牽著名	牵著名
牽著書	牵著书
牽著稱	牵著称
牽著者	牵著者
牽著述	牵著述
牽著錄	牵著录
狂牛症	疯牛病
狄托	铁托
狗隻	犬只
猜著	猜着
猜著作	猜著作
猜著名	猜著名
猜著書	猜着书
猜著稱	猜著称
猜著者	猜著者
猜著述	猜著述
猜著錄	猜著录
猶豫著	犹豫着
獅子山共和國	塞拉利昂共和国
獨立國協	独联体
獨立國家國協	独立国家联合体
獲著	获着
獲著作	获著作
獲著名	获著名
獲著書	获著书
獲著稱	获著称
獲著者	获著者
獲著述	获著述
獲著錄	获著录
玩著	玩着
玻利維亞多民族國	多民族玻利维亚国
玻里尼西亞	波利尼西亚
班傑明	本杰明
班固著	班固著
瓜地馬拉	危地马拉
瓦倫西亞	巴伦西亚
甘比亞	冈比亚
甘迺迪	肯尼迪
甚麼	什么
甚麽	什么
甜著	甜着
甜著作	甜著作
甜著名	甜著名
甜著書	甜著书
甜著稱	甜著称
甜著者	甜著者
甜著述	甜著述
甜著錄	甜著录
用著	用着
用著作	用著作
用著名	用著名
用著書	用著书
用著稱	用著称
用著者	用著者
用著述	用著述
用著錄	用著录
留尼旺	留尼汪
留著	留着
留著作	留著作
留著名	留著名
留著書	留着书
留著稱	留著称
留著者	留著者
留著述	留著述
留著錄	留著录
畢卡索	毕加索
畫著	画着
畫著作	画著作
畫著名	画著名
畫著稱	画著称
畫著者	画著者
當勞·特朗普	唐纳德·特朗普
當奴·特朗普	唐纳德·特朗普
當著	当着
當著作	当著作
當著名	当著名
當著書	当著书
當著稱	当著称
當著者	当著者
當著述	当著述
當著錄	当著录
畿內亞	几内亚
疊代	迭代
疑著	疑着
疑著作	疑著作
疑著名	疑著名
疑著書	疑著书
疑著稱	疑著称
疑著者	疑著者
疑著述	疑著述
疑著錄	疑著录
瘋牛症	疯牛病
發著	发着
發著《	发著《
發著作	发著作
發著名	发著名
發著稱	发著称
發著者	发著者
白朗寧	勃朗宁
百慕達	百慕大
皮雅斯·布士南	皮尔斯·布鲁斯南
皺著	皱着
皺著作	皱著作
皺著名	皱著名
皺著書	皱著书
皺著稱	皱著称
皺著者	皱著者
皺著述	皱著述
皺著錄	皱著录
盛著	盛着
盛著作	盛著作
盛著名	盛著名
盛著書	盛著书
盛著稱	盛著称
盛著者	盛著者
盛著述	盛著述
盛著錄	盛著录
盧安達	卢旺达
盯著	盯着
盯著作	盯著作
盯著名	盯著名
盯著書	盯着书
盯著稱	盯著称
盯著者	盯著者
盯著述	盯著述
盯著錄	盯著录
看著	看着
看著作	看著作
看著名	看著名
看著書	看着书
看著稱	看著称
看著者	看著者
看著述	看著述
看著錄	看著录
真人騷	真人秀
睡著	睡着
睡著作	睡著作
睡著名	睡著名
睡著書	睡著书
睡著稱	睡著称
睡著者	睡著者
睡著述	睡著述
睡著錄	睡著录
瞞著	瞒着
瞞著作	瞒著作
瞞著名	瞒著名
瞞著書	瞒著书
瞞著稱	瞒著称
瞞著者	瞒著者
瞞著述	瞒著述
瞞著錄	瞒著录
瞧著	瞧着
瞧著作	瞧著作
瞧著名	瞧著名
瞧著書	瞧着书
瞧著稱	瞧著称
瞧著者	瞧著者
瞧著述	瞧著述
瞧著錄	瞧著录
瞪著	瞪着
瞪著作	瞪著作
瞪著名	瞪著名
瞪著書	瞪著书
瞪著稱	瞪著称
瞪著者	瞪著者
瞪著述	瞪著述
瞪著錄	瞪著录
矛盾著	矛盾着
知識份子	知识分子
矽	硅
矽塵	矽尘
矽尘	矽尘
矽片	硅片
矽肺	矽肺
矽谷	硅谷
矽鋼	矽钢
矽钢	矽钢
硬碟	硬盘
硬體	硬件
碧咸	贝克汉姆
磁碟	磁盘
磁軌	磁道
祖雲達斯	尤文图斯
福著	福着
福著作	福著作
福著名	福著名
福著書	福著书
福著稱	福著称
福著者	福著者
福著述	福著述
福著錄	福著录
福馬林	福尔马林
私帳	私账
私隱	隐私
程式控制	程控
程式設計師	程序员
積架	捷豹
積極份子	积极分子
穫著	获着
空中巴士	空中客车
空氣品質	空气质量
空氣質素	空气质量
空著	空着
空著作	空著作
空著名	空著名
空著書	空著书
空著稱	空著称
空著者	空著者
空著述	空著述
空著錄	空著录
穿梭機	航天飞机
穿著	穿着
穿著作	穿著作
穿著名	穿著名
穿著書	穿著书
穿著稱	穿著称
穿著者	穿著者
穿著述	穿著述
穿著錄	穿著录
突尼西亞	突尼斯
立著	立着
立著《	立著《
立著作	立著作
立著名	立著名
立著有	立著有
立著称	立著称
立著稱	立著称
立著者	立著者
立著（	立著（
站著	站着
站著作	站著作
站著名	站著名
站著書	站著书
站著稱	站著称
站著者	站著者
站著述	站著述
站著錄	站著录
笑著	笑着
笑著作	笑著作
笑著名	笑著名
笑著書	笑著书
笑著稱	笑著称
笑著者	笑著者
笑著述	笑著述
笑著錄	笑著录
笨豬跳	蹦极跳
筆帳	笔账
算帳	算账
管帳	管账
管著	管着
管著作	管著作
管著名	管著名
管著書	管著书
管著稱	管著称
管著者	管著者
管著述	管著述
管著錄	管著录
簽帳	签账
簽著	签着
米高·奧雲	迈克尔·欧文
糊塗帳	糊涂账
糖份	糖分
紀錄著	纪录着
約翰尼斯堡	约翰内斯堡
紐幾內亞	新几内亚
紐澤西	新泽西
紐西蘭	新西兰
索忍尼辛	索尔仁尼琴
索羅門群島	所罗门群岛
索贊尼辛	索尔仁尼琴
索馬利亞	索马里
索馬利蘭	索马里兰
紮著	扎着
紮著作	扎著作
紮著名	扎著名
紮著書	扎著书
紮著稱	扎著称
紮著者	扎著者
紮著述	扎著述
紮著錄	扎著录
組份	组分
結他	吉他
結帳	结账
綁著	绑着
綁著作	绑著作
綁著名	绑著名
綁著書	绑著书
綁著稱	绑著称
綁著者	绑著者
綁著述	绑著述
綁著錄	绑著录
經常帳	经常账
經濟帳	经济账
維德角	佛得角
維根斯坦	维特根斯坦
網域名稱	域名
網站連結	网站链接
網路	网络
網際網絡	互联网
網際網路	互联网
網頁連結	网页链接
緣份	缘分
縱著	纵着
總帳	总账
繃著	绷着
織著	织着
繞著	绕着
繞著作	绕著作
繞著名	绕著名
繞著書	绕著书
繞著稱	绕著称
繞著者	绕著者
繞著述	绕著述
繞著錄	绕著录
繪著	绘着
繪著。	绘著。
繪著名	绘著名
繪著称	绘著称
繪著稱	绘著称
繪著，	绘著，
繫著	系着
纏著	缠着
纏著作	缠著作
纏著名	缠著名
纏著書	缠著书
纏著稱	缠著称
纏著者	缠著者
纏著述	缠著述
纏著錄	缠著录
绑紧跳	蹦极跳
罩著	罩着
罩著作	罩著作
罩著名	罩著名
罩著書	罩著书
罩著稱	罩著称
罩著者	罩著者
罩著述	罩著述
罩著錄	罩著录
罵著	骂着
罵著作	骂著作
罵著名	骂著名
罵著書	骂著书
罵著稱	骂著称
罵著者	骂著者
罵著述	骂著述
罵著錄	骂著录
羅亞爾	卢瓦尔
羅浮宮	卢浮宫
羅蘋	罗宾
美著	美着
美著作	美著作
美著名	美著名
美著書	美著书
美著称	美著称
美著稱	美著称
美著者	美著者
美著述	美著述
美著錄	美著录
義大利	意大利
義裔	意裔
翁山蘇姬	昂山素季
耀著	耀着
耀著作	耀著作
耀著名	耀著名
耀著書	耀著书
耀著稱	耀著称
耀著者	耀著者
耀著述	耀著述
耀著錄	耀著录
考著	考着
考著作	考著作
考著名	考著名
考著書	考著书
考著稱	考著称
考著者	考著者
考著述	考著述
考著錄	考著录
耶加達	雅加达
聖佐治	圣乔治
聖克里斯多福及尼維斯	圣基茨和尼维斯
聖吉斯納域斯	圣基茨和尼维斯
聖地牙哥	圣地亚哥
聖多美普林西比	圣多美和普林西比
聖文森及格瑞那丁	圣文森特和格林纳丁斯
聖文森國	圣文森特和格林纳丁斯
聖露西亞	圣卢西亚
聖馬利諾	圣马力诺
聞著	闻着
職份	职分
聽著	听着
聽著作	听著作
聽著名	听著名
聽著書	听著书
聽著稱	听著称
聽著者	听著者
聽著述	听著述
聽著錄	听著录
背著	背着
背著作	背著作
背著名	背著名
背著書	背著书
背著稱	背著称
背著者	背著者
背著述	背著述
背著錄	背著录
胺基酸	氨基酸
膠著	胶着
膠著作	胶著作
膠著名	胶著名
膠著書	胶著书
膠著稱	胶著称
膠著者	胶著者
膠著述	胶著述
膠著錄	胶著录
臨著	临着
臨著作	临著作
臨著名	临著名
臨著書	临著书
臨著稱	临著称
臨著者	临著者
臨著述	临著述
臨著錄	临著录
與著	与着
與著作	与著作
與著名	与著名
與著書	与著书
與著稱	与著称
與著者	与著者
與著述	与著述
與著錄	与著录
舊帳	旧账
舒麥加	舒马赫
艾菲爾	埃菲尔
芮氏0	里氏0
芮氏1	里氏1
芮氏2	里氏2
芮氏3	里氏3
芮氏4	里氏4
芮氏5	里氏5
芮氏6	里氏6
芮氏7	里氏7
芮氏8	里氏8
芮氏9	里氏9
芮氏地震規模	里氏地震规模
芮氏規模	里氏震级
若且唯若	当且仅当
苦著	苦着
苦著作	苦著作
苦著名	苦著名
苦著書	苦著书
苦著稱	苦著称
苦著者	苦著者
苦著述	苦著述
苦著錄	苦著录
英吋	英寸
英呎	英尺
茅利塔尼亞	毛里塔尼亚
荷姆茲	霍尔木兹
荷尼阿拉	霍尼亚拉
荷里活	好莱坞
荷里活廣場	荷里活广场
荷里活道	荷里活道
莫三比克	莫桑比克
莫士比港	莫尔斯比港
菁寮	菁寮
菫	堇
華倫西亞	巴伦西亚
華勒沙	瓦文萨
華里沙	瓦文萨
萌島	马恩岛
萬那杜	瓦努阿图
落著	落着
落著作	落著作
落著名	落著名
落著書	落著书
落著稱	落著称
落著者	落著者
落著述	落著述
落著錄	落著录
落車	下车
葉里溫	埃里温
葉門	也门
著人	着人
著什	着什
著他	着他
著令	着令
著位	着位
著你	着你
著便	着便
著力	着力
著勁	着劲
著呢	着呢
著哩	着哩
著地	着地
著墨	着墨
著她	着她
著妳	着妳
著它	着它
著定	着定
著實	着实
著己	着己
著帳	着帐
著床	着床
著庸	着庸
著式	着式
著心	着心
著志	着志
著忙	着忙
著急	着急
著惱	着恼
著想	着想
著意	着意
著慌	着慌
著我	着我
著手	着手
著抹	着抹
著摸	着摸
著撰	着撰
著數	着数
著明	着明
著末	着末
著格	着格
著棋	着棋
著業	着业
著極	着极
著槁	着藁
著氣	着气
著法	着法
著涼	着凉
著淺	着浅
著火	着火
著然	着然
著甚	着甚
著甚麼	着什么
著生	着生
著疑	着疑
著白	着白
著相	着相
著眼	着眼
著祂	着祂
著稿	着稿
著積	着积
著筆	着笔
著節	着节
著籍	着籍
著絆	着绊
著絲	着丝
著綠	着绿
著緊	着紧
著緋	着绯
著緑	着緑
著績	着绩
著聞	着闻
著聲	着声
著肉	着肉
著腳	着脚
著艦	着舰
著色	着色
著花	着花
著莫	着莫
著落	着落
著著	着着
著處	着处
著號	着号
著衣	着衣
著裝	着装
著要	着要
著警	着警
著趣	着趣
著跡	着迹
著迷	着迷
著邊	着边
著重	着重
著錄	着录
著録	着録
著陸	着陆
著雝	着雝
著鞭	着鞭
著題	着题
著驚	着惊
著體	着体
著魔	着魔
著麼	着么
葛摩	科摩罗
葛萊美獎	格莱美奖
蒙特內哥羅	黑山
蒙特婁	蒙特利尔
蒙著	蒙着
蒙著作	蒙著作
蒙著名	蒙著名
蒙著書	蒙著书
蒙著稱	蒙著称
蒙著者	蒙著者
蒙著述	蒙著述
蒙著錄	蒙著录
蒲朗克	普朗克
蒲美蓬	普密蓬
蒲隆地	布隆迪
蓋亞那	圭亚那
蓋著	盖着
蓋著作	盖著作
蓋著名	盖著名
蓋著稱	盖著称
蓋達組織	基地组织
蕭士塔高維奇	肖斯塔科维奇
蕭士達高維契	肖斯塔科维奇
薛丁格	薛定谔
藉著	借着
藍芽	蓝牙
藏著	藏着
藏著作	藏著作
藏著名	藏著名
藏著書	藏著书
藏著稱	藏著称
藏著者	藏著者
藏著述	藏著述
藏著錄	藏著录
蘇利南	苏里南
蘇辛尼津	索尔仁尼琴
蘊涵著	蕴涵着
蘭卡威	浮罗交怡
蘸著	蘸着
蘸著作	蘸著作
蘸著名	蘸著名
蘸著書	蘸著书
蘸著稱	蘸著称
蘸著者	蘸著者
蘸著述	蘸著述
蘸著錄	蘸著录
蘿拉	劳拉
虛擬實境	虚拟现实
蚵寮	蚵寮
螢光棒	荧光棒
螢屏	荧屏
行人路	人行道
行人路权	行人路权
行人路權	行人路权
行動作業系統	移动操作系统
行動應用程式	移动应用程序
行動支付	移动支付
行動網路	移动网络
行動裝置	移动设备
行動電話	移动电话
行政總裁	首席执行官
行著	行着
行著作	行著作
行著名	行著名
行著書	行著书
行著稱	行著称
行著者	行著者
行著述	行著述
行著錄	行著录
衝著	冲着
衣索匹亞	埃塞俄比亚
衣索比亞	埃塞俄比亚
衣著	衣着
衣著作	衣著作
衣著名	衣著名
衣著書	衣著书
衣著称	衣著称
衣著稱	衣著称
衣著者	衣著者
衣著述	衣著述
衣著錄	衣著录
表姊	表姐
裝著	装着
裝著作	装著作
裝著名	装著名
裝著書	装著书
裝著稱	装著称
裝著者	装著者
裝著述	装著述
裝著錄	装著录
裹著	裹着
裹著作	裹著作
裹著名	裹著名
裹著書	裹著书
裹著稱	裹著称
裹著者	裹著者
裹著述	裹著述
裹著錄	裹著录
複製人	克隆人
西元1	公元1
西元2	公元2
西元3	公元3
西元4	公元4
西元5	公元5
西元6	公元6
西元7	公元7
西元8	公元8
西元9	公元9
西元前	公元前
西洋棋	国际象棋
西維爾	塞维利亚
西臺人	赫梯人
西臺國	赫梯国
西臺帝	赫梯帝
西臺文	赫梯文
西臺族	赫梯族
西臺王	赫梯王
西臺語	赫梯语
要帳	要账
覆著	覆着
覆蓋著	覆盖着
見著	见着
見著作	见著作
見著名	见著名
見著書	见著书
見著稱	见著称
見著者	见著者
見著述	见著述
見著錄	见著录
規畫	规划
視著	视着
視著作	视著作
視著名	视著名
視著稱	视著称
視著者	视著者
解像度	分辨率
解析度	分辨率
計畫	计划
記帳	记账
記憶體	内存
記著	记着
記著作	记著作
記著名	记著名
記著書	记著书
記著稱	记著称
記著者	记著者
記著述	记著述
記著錄	记著录
記錄著	记录着
試著	试着
試著作	试著作
試著名	试著名
試著書	试著书
試著稱	试著称
試著者	试著者
試著述	试著述
試著錄	试著录
認帳	认账
語著	语着
語著作	语著作
語著名	语著名
語著書	语著书
語著稱	语著称
語著者	语著者
語著述	语著述
語著錄	语著录
說著	说着
說著作	说著作
說著稱	说著称
說著者	说著者
說著述	说著述
諮	咨
諾曼第	诺曼底
警戒著	警戒着
護著	护着
護著作	护著作
護著名	护著名
護著書	护著书
護著稱	护著称
護著者	护著者
護著述	护著述
護著錄	护著录
變著	变着
變著作	变著作
變著名	变著名
變著書	变著书
變著稱	变著称
變著者	变著者
變著述	变著述
變著錄	变著录
豎著	竖着
豎著作	竖著作
豎著名	竖著名
豎著書	竖著书
豎著稱	竖著称
豎著者	竖著者
豎著述	竖著述
豎著錄	竖著录
象徵著	象征着
象徵著名	象征著名
象牙海岸	科特迪瓦
貝南共和國	贝宁共和国
貝爾格勒	贝尔格莱德
貝里斯	伯利兹
負著	负着
財務長、	首席财务官、
財務長。	首席财务官。
財務長，	首席财务官，
貢寮	贡寮
買帳	买账
資料庫	数据库
資訊時代	信息时代
資訊理論	信息论
賈伯斯	乔布斯
賒帳	赊账
賓·拉登	本·拉登
賓士	奔驰
賓拉登	本拉登
賴帳	赖账
賴比瑞亞	利比里亚
賴索托	莱索托
賽普勒斯	塞浦路斯
赫魯雪夫	赫鲁晓夫
走為上著	走为上着
走著	走着
走著作	走著作
走著名	走著名
走著書	走著书
走著稱	走著称
走著者	走著者
走著述	走著述
走著錄	走著录
趁著	趁着
超連結	超链接
趕著	赶着
趕著作	赶著作
趕著名	赶著名
趕著書	赶著书
趕著稱	赶著称
趕著者	赶著者
趕著述	赶著述
趕著錄	赶著录
趴著	趴着
趴著作	趴著作
趴著名	趴著名
趴著書	趴著书
趴著稱	趴著称
趴著者	趴著者
趴著述	趴著述
趴著錄	趴著录
跑著	跑着
跑著作	跑著作
跑著名	跑著名
跑著書	跑著书
跑著稱	跑著称
跑著者	跑著者
跑著述	跑著述
跑著錄	跑著录
跟著	跟着
跟著作	跟著作
跟著名	跟著名
跟著書	跟著书
跟著稱	跟著称
跟著者	跟著者
跟著述	跟著述
跟著錄	跟著录
跪著	跪着
跪著作	跪著作
跪著名	跪著名
跪著書	跪著书
跪著稱	跪著称
跪著者	跪著者
跪著述	跪著述
跪著錄	跪著录
跳著	跳着
跳著作	跳著作
跳著名	跳著名
跳著書	跳著书
跳著稱	跳著称
跳著者	跳著者
跳著述	跳著述
跳著錄	跳著录
踏著	踏着
踏著作	踏著作
踏著名	踏著名
踏著書	踏著书
踏著稱	踏著称
踏著者	踏著者
踏著述	踏著述
踏著錄	踏著录
踩著	踩着
踩著作	踩著作
踩著名	踩著名
踩著書	踩著书
踩著稱	踩著称
踩著者	踩著者
踩著述	踩著述
踩著錄	踩著录
躍著	跃着
躍著作	跃著作
躍著名	跃著名
躍著書	跃著书
躍著稱	跃著称
躍著者	跃著者
躍著述	跃著述
躍著錄	跃著录
身份	身份
身分	身份
身著	身着
身著作	身著作
身著名	身著名
身著書	身著书
身著稱	身著称
身著者	身著者
身著述	身著述
身著錄	身著录
躺著	躺着
躺著作	躺著作
躺著名	躺著名
躺著書	躺著书
躺著稱	躺著称
躺著者	躺著者
躺著述	躺著述
躺著錄	躺著录
車諾比	切尔诺贝利
軟碟機	软驱
軟體	软件
軟體動物	软体动物
軟體家具	软体家具
軟體生物	软体生物
載著	载着
載著作	载著作
載著名	载著名
載著書	载著书
載著稱	载著称
載著者	载著者
載著述	载著述
載著錄	载著录
轉帳	转账
轉殖	克隆
轉著	转着
轉著作	转著作
轉著名	转著名
轉著書	转著书
轉著稱	转著称
轉著者	转著者
轉著述	转著述
轉著錄	转著录
辛巴威	津巴布韦
辛康納利	肖恩·康纳利
辦著	办着
辦著作	办著作
辦著名	办著名
辦著書	办著书
辦著稱	办著称
辦著者	办著者
辦著述	办著述
辦著錄	办著录
迦納	加纳
迫著	迫着
迴圈	循环
追著	追着
追著作	追著作
追著名	追著名
追著書	追著书
追著稱	追著称
追著者	追著者
追著述	追著述
追著錄	追著录
逆著	逆着
逆著作	逆著作
逆著名	逆著名
逆著書	逆著书
逆著稱	逆著称
逆著者	逆著者
逆著述	逆著述
逆著錄	逆著录
逕入	径入
逕到	径到
逕取	径取
逕啟	径启
逕寄	径寄
逕庭	径庭
逕往	径往
逕流	径流
逕自	径自
逕行	径行
逕迎	径迎
連結他	连结他
連著	连着
連著作	连著作
連著名	连著名
連著書	连著书
連著稱	连著称
連著者	连著者
連著述	连著述
連著錄	连著录
進帳	进账
逼著	逼着
逼著作	逼著作
逼著名	逼著名
逼著書	逼著书
逼著稱	逼著称
逼著者	逼著者
逼著述	逼著述
逼著錄	逼著录
遇著	遇着
遇著作	遇著作
遇著名	遇著名
遇著書	遇著书
遇著称	遇著称
遇著稱	遇著称
遇著者	遇著者
遇著述	遇著述
遇著錄	遇著录
運算元	算子
遍佈著	遍布着
遍布著	遍布着
過份	过分
過著	过着
過著作	过著作
過著名	过著名
過著稱	过著称
過著者	过著者
過著述	过著述
過著錄	过著录
道瓊	道琼斯
道瓊斯	道琼斯
達·文西	达·芬奇
達文西	达芬奇
達著	达着
達著作	达著作
達著名	达著名
達著書	达著书
達著稱	达著称
達著者	达著者
達著述	达著述
達著錄	达著录
還帳	还账
邱吉爾	丘吉尔
部份	部分
都卜勒	多普勒
配合著	配合着
配合著名	配合著名
配著	配着
配著作	配著作
配著名	配著名
配著書	配著书
配著稱	配著称
配著者	配著者
配著述	配著述
配著錄	配著录
醜著	丑着
醜著作	丑著作
醜著名	丑著名
醜著書	丑著书
醜著稱	丑著称
醜著者	丑著者
醜著述	丑著述
醜著錄	丑著录
釀著	酿着
釀著作	酿著作
釀著名	酿著名
釀著書	酿著书
釀著稱	酿著称
釀著者	酿著者
釀著述	酿著述
釀著錄	酿著录
金夏沙	金沙萨
金氏世界紀錄	吉尼斯世界纪录
鈽	钚
鉲	锎
鉳	锫
銷帳	销账
鋂	镅
鋪著	铺着
鋪著作	铺著作
鋪著名	铺著名
鋪著書	铺著书
鋪著稱	铺著称
鋪著者	铺著者
鋪著述	铺著述
鋪著錄	铺著录
錄影帶	录像带
錼	镎
鍅	钫
鎝	锝
鏈結	链接
鐵達尼號	泰坦尼克号
鑀	锿
閉著	闭着
閉著作	闭著作
閉著名	闭著名
閉著書	闭著书
閉著稱	闭著称
閉著者	闭著者
閉著述	闭著述
閉著錄	闭著录
開帳	开账
開機率	开机率
開著	开着
開著作	开著作
開著名	开著名
開著書	开著书
開著稱	开著称
開著者	开著者
開著述	开著述
開著錄	开著录
閑著	闲着
閑著作	闲著作
閑著名	闲著名
閑著書	闲著书
閑著稱	闲著称
閑著者	闲著者
閑著述	闲著述
閑著錄	闲著录
閒著	闲着
關係著	关系着
關帳	关账
關著	关着
關著作	关著作
關著名	关著名
關著書	关著书
關著稱	关著称
關著者	关著者
關著述	关著述
關著錄	关著录
阿布達比	阿布扎比
阿拉伯聯合大公國	阿拉伯联合酋长国
阿爾蓋達組織	基地组织
阿迪斯阿貝巴	亚的斯亚贝巴
附著	附着
附著作	附著作
附著名	附著名
附著書	附著书
附著稱	附著称
附著者	附著者
附著述	附著述
附著錄	附著录
陋著	陋着
陋著作	陋著作
陋著名	陋著名
陋著書	陋著书
陋著稱	陋著称
陋著者	陋著者
陋著述	陋著述
陋著錄	陋著录
陪著	陪着
陪著作	陪著作
陪著名	陪著名
陪著書	陪著书
陪著稱	陪著称
陪著者	陪著者
陪著述	陪著述
陪著錄	陪著录
隔著	隔着
隔著作	隔著作
隔著名	隔著名
隔著書	隔著书
隔著稱	隔著称
隔著者	隔著者
隔著述	隔著述
隔著錄	隔著录
隨著	随着
隨著作	随著作
隨著名	随著名
隨著書	随著书
隨著稱	随著称
隨著者	随著者
隨著述	随著述
隨著錄	随著录
隻字片語	只字片语
隻言片語	只言片语
雅爾達	雅尔塔
雅穆索戈	亚穆苏克罗
雅著	雅着
雅著作	雅著作
雅著名	雅著名
雅著書	雅著书
雅著称	雅著称
雅著稱	雅著称
雅著者	雅著者
雅著述	雅著述
雅著錄	雅著录
雜著	杂着
雜著作	杂著作
雜著名	杂著名
雜著書	杂著书
雜著稱	杂著称
雜著者	杂著者
雜著述	杂著述
雜著錄	杂著录
雜訊	噪声
雷伊泰灣	莱特湾
雷射	激光
雷諾瓦	雷诺阿
電單車	摩托车
電晶體	晶体管
電腦程式	计算机程序
電視劇集	电视剧
電視影集	电视系列剧
霍爾斯坦	荷尔斯泰因
非份	非分
非同步	异步
靠著	靠着
靠著作	靠著作
靠著名	靠著名
靠著稱	靠著称
靠著者	靠著者
靠著述	靠著述
靠著錄	靠著录
韌體	固件
韓戰	朝鲜战争
音效卡	声卡
音樂錄影帶	音乐录影带
響著	响着
響著作	响著作
響著名	响著名
響著書	响著书
響著稱	响著称
響著者	响著者
響著述	响著述
響著錄	响著录
頂著	顶着
頂著作	顶著作
頂著名	顶著名
頂著書	顶著书
頂著稱	顶著称
頂著者	顶著者
頂著述	顶著述
頂著錄	顶著录
順著	顺着
順著作	顺著作
順著名	顺著名
順著書	顺著书
順著稱	顺著称
順著者	顺著者
順著述	顺著述
順著錄	顺著录
領著	领着
領著作	领著作
領著名	领著名
領著書	领著书
領著稱	领著称
領著者	领著者
領著述	领著述
領著錄	领著录
頻寬	带宽
顯示卡	显卡
顯著	显著
颳著	刮着
飃著	飘着
飄著	飘着
飄著作	飘著作
飄著名	飘著名
飄著書	飘著书
飄著稱	飘著称
飄著者	飘著者
飄著述	飘著述
飄著錄	飘著录
飛彈	导弹
餘	余
馬利共和國	马里共和国
馬勒當拿	马拉多纳
馬拉威	马拉维
馬拉度納	马拉多纳
馬斯垂克	马斯特里赫特
馬爾他	马耳他
馬爾地夫	马尔代夫
駕著	驾着
駕著作	驾著作
駕著名	驾著名
駕著書	驾著书
駕著稱	驾著称
駕著者	驾著者
駕著述	驾著述
駕著錄	驾著录
駛著	驶着
騎著	骑着
騎著作	骑著作
騎著名	骑著名
騎著書	骑著书
騎著稱	骑著称
騎著者	骑著者
騎著述	骑著述
騎著錄	骑著录
騙著	骗着
騙著作	骗著作
騙著名	骗著名
騙著書	骗著书
騙著稱	骗著称
騙著者	骗著者
騙著述	骗著述
騙著錄	骗著录
高畫質	高清
高著	高着
高著作	高著作
高著名	高著名
高著書	高著书
高著称	高著称
高著稱	高著称
高著者	高著者
高著述	高著述
高著錄	高著录
鬥著	斗着
鬥著作	斗著作
鬥著名	斗著名
鬥著書	斗著书
鬥著稱	斗著称
鬥著者	斗著者
鬥著述	斗著述
鬥著錄	斗著录
鬧著	闹着
魚雷	鱼雷
鱼雷	鱼雷
鹽份	盐分
鹿寮	鹿寮
麥寮	麦寮
麻薩諸塞	马萨诸塞
麼著	么着
黎克特制	里氏
黏著	黏着
黏著作	黏著作
黏著名	黏著名
黏著書	黏著书
黏著稱	黏著称
黏著者	黏著者
黏著述	黏著述
黏著錄	黏著录
黛安娜	戴安娜
點著	点着
點著作	点著作
點著名	点著名
點著稱	点著称
點著者	点著者
點著述	点著述
點著錄	点著录
點陣圖	位图
